n	load_factor	entry_count	i_refs	i_misses	lli_misses	i_missrate	lli_missrate	d_refs	d_refs_rd	d_refs_wr	d_misses	d_misses_rd	d_misses_wr	lld_misses	lld_misses_rd	lld_misses_wr	d_missrate	d_missrate_rd	d_missrate_wr	lld_missrate	lld_missrate_rd	lld_missrate_wr	ll_refs	ll_refs_rd	ll_refs_wr	ll_misses	ll_misses_rd	ll_misses_wr	ll_missrate	ll_missrate_rd	ll_missrate_wr	initial_fill	rm	fill	sum	find	
0	0.1	0	234046	1455	1390	0.62%	0.59%	80405	59019	21386	3379	2734	645	2660	2102	558	4.2%	4.6%	3.0%	3.3%	3.6%	2.6%	4834	4189	645	4050	3492	558	1.3%	1.2%	2.6%	0.001735	0.000405	0.000323	0.000742	0.001307	
0	0.25	0	233973	1451	1389	0.62%	0.59%	80372	59000	21372	3379	2734	645	2660	2102	558	4.2%	4.6%	3.0%	3.3%	3.6%	2.6%	4830	4185	645	4049	3491	558	1.3%	1.2%	2.6%	0.001768	0.000378	0.000319	0.000746	0.001394	
0	0.5	0	234170	1451	1389	0.62%	0.59%	80443	59044	21399	3379	2734	645	2660	2102	558	4.2%	4.6%	3.0%	3.3%	3.6%	2.6%	4830	4185	645	4049	3491	558	1.3%	1.2%	2.6%	0.001845	0.000762	0.000330	0.001005	0.001482	
0	0.65	0	233983	1453	1390	0.62%	0.59%	80378	59002	21376	3379	2734	645	2660	2102	558	4.2%	4.6%	3.0%	3.3%	3.6%	2.6%	4832	4187	645	4050	3492	558	1.3%	1.2%	2.6%	0.001854	0.000623	0.000342	0.000688	0.001178	
0	0.75	0	233984	1451	1389	0.62%	0.59%	80373	59000	21373	3379	2734	645	2660	2102	558	4.2%	4.6%	3.0%	3.3%	3.6%	2.6%	4830	4185	645	4049	3491	558	1.3%	1.2%	2.6%	0.001792	0.000656	0.000326	0.000767	0.001560	
0	0.85	0	233959	1451	1389	0.62%	0.59%	80371	58999	21372	3379	2734	645	2660	2102	558	4.2%	4.6%	3.0%	3.3%	3.6%	2.6%	4830	4185	645	4049	3491	558	1.3%	1.2%	2.6%	0.001789	0.000732	0.000326	0.000756	0.001117	
0	0.9	0	233842	1452	1389	0.62%	0.59%	80333	58972	21361	3379	2734	645	2660	2102	558	4.2%	4.6%	3.0%	3.3%	3.6%	2.6%	4831	4186	645	4049	3491	558	1.3%	1.2%	2.6%	0.002169	0.000538	0.000323	0.000920	0.001626	
0	0.95	0	233895	1453	1390	0.62%	0.59%	80341	58978	21363	3379	2734	645	2660	2102	558	4.2%	4.6%	3.0%	3.3%	3.6%	2.6%	4832	4187	645	4050	3492	558	1.3%	1.2%	2.6%	0.001959	0.000394	0.000521	0.000651	0.001231	
0	0.98	0	233855	1451	1389	0.62%	0.59%	80332	58974	21358	3379	2734	645	2660	2102	558	4.2%	4.6%	3.0%	3.3%	3.6%	2.6%	4830	4185	645	4049	3491	558	1.3%	1.2%	2.6%	0.003124	0.000464	0.000353	0.000644	0.001007	
0	1	1	235051	1473	1401	0.63%	0.60%	80894	59348	21546	3385	2739	646	2660	2101	559	4.2%	4.6%	3.0%	3.3%	3.5%	2.6%	4858	4212	646	4061	3502	559	1.3%	1.2%	2.6%	0.003050	0.001372	0.000663	0.000647	0.001184	
1	0.1	0	235048	1470	1404	0.63%	0.60%	80827	59315	21512	3389	2744	645	2662	2104	558	4.2%	4.6%	3.0%	3.3%	3.5%	2.6%	4859	4214	645	4066	3508	558	1.3%	1.2%	2.6%	0.002789	0.000518	0.000353	0.000768	0.003445	
1	0.25	0	235091	1465	1402	0.62%	0.60%	80831	59318	21513	3389	2744	645	2662	2104	558	4.2%	4.6%	3.0%	3.3%	3.5%	2.6%	4854	4209	645	4064	3506	558	1.3%	1.2%	2.6%	0.001877	0.000455	0.000341	0.000702	0.002169	
1	0.5	1	236698	1499	1422	0.63%	0.60%	81505	59777	21728	3396	2750	646	2663	2104	559	4.2%	4.6%	3.0%	3.3%	3.5%	2.6%	4895	4249	646	4085	3526	559	1.3%	1.2%	2.6%	0.002697	0.002192	0.000654	0.001031	0.003738	
1	0.65	1	236757	1500	1422	0.63%	0.60%	81522	59787	21735	3396	2750	646	2663	2104	559	4.2%	4.6%	3.0%	3.3%	3.5%	2.6%	4896	4250	646	4085	3526	559	1.3%	1.2%	2.6%	0.002284	0.002713	0.000663	0.001141	0.002297	
1	0.75	1	236652	1500	1423	0.63%	0.60%	81479	59759	21720	3396	2750	646	2663	2104	559	4.2%	4.6%	3.0%	3.3%	3.5%	2.6%	4896	4250	646	4086	3527	559	1.3%	1.2%	2.6%	0.002840	0.001766	0.000663	0.000870	0.002471	
1	0.85	1	236624	1499	1422	0.63%	0.60%	81476	59758	21718	3396	2750	646	2663	2104	559	4.2%	4.6%	3.0%	3.3%	3.5%	2.6%	4895	4249	646	4085	3526	559	1.3%	1.2%	2.6%	0.003087	0.001805	0.000627	0.000863	0.002436	
1	0.9	1	236832	1501	1423	0.63%	0.60%	81554	59806	21748	3396	2750	646	2663	2104	559	4.2%	4.6%	3.0%	3.3%	3.5%	2.6%	4897	4251	646	4086	3527	559	1.3%	1.2%	2.6%	0.002822	0.001766	0.000645	0.001189	0.002332	
1	0.95	1	236926	1500	1422	0.63%	0.60%	81570	59813	21757	3396	2750	646	2663	2104	559	4.2%	4.6%	3.0%	3.3%	3.5%	2.6%	4896	4250	646	4085	3526	559	1.3%	1.2%	2.6%	0.002816	0.001357	0.000630	0.001115	0.002389	
1	0.98	1	236639	1497	1420	0.63%	0.60%	81476	59756	21720	3396	2750	646	2663	2104	559	4.2%	4.6%	3.0%	3.3%	3.5%	2.6%	4893	4247	646	4083	3524	559	1.3%	1.2%	2.6%	0.003529	0.001903	0.000652	0.000748	0.003756	
1	1	2	236665	1493	1415	0.63%	0.60%	81560	59813	21747	3395	2749	646	2662	2103	559	4.2%	4.6%	3.0%	3.3%	3.5%	2.6%	4888	4242	646	4077	3518	559	1.3%	1.2%	2.6%	0.002390	0.002052	0.001253	0.000821	0.003272	
2	0.1	0	235472	1470	1404	0.62%	0.60%	80963	59410	21553	3390	2744	646	2663	2104	559	4.2%	4.6%	3.0%	3.3%	3.5%	2.6%	4860	4214	646	4067	3508	559	1.3%	1.2%	2.6%	0.001861	0.000465	0.000610	0.000681	0.003636	
2	0.25	1	237176	1499	1422	0.63%	0.60%	81653	59879	21774	3396	2750	646	2663	2104	559	4.2%	4.6%	3.0%	3.3%	3.5%	2.6%	4895	4249	646	4085	3526	559	1.3%	1.2%	2.6%	0.002378	0.001463	0.000662	0.001453	0.003106	
2	0.5	2	237392	1505	1424	0.63%	0.60%	81768	59967	21801	3396	2750	646	2663	2104	559	4.2%	4.6%	3.0%	3.3%	3.5%	2.6%	4901	4255	646	4087	3528	559	1.3%	1.2%	2.6%	0.002311	0.002336	0.001047	0.000866	0.003538	
2	0.65	2	237696	1506	1424	0.63%	0.60%	81865	60027	21838	3396	2750	646	2663	2104	559	4.1%	4.6%	3.0%	3.3%	3.5%	2.6%	4902	4256	646	4087	3528	559	1.3%	1.2%	2.6%	0.002418	0.002765	0.001462	0.001418	0.004001	
2	0.75	3	237557	1507	1425	0.63%	0.60%	81862	60038	21824	3396	2750	646	2663	2104	559	4.1%	4.6%	3.0%	3.3%	3.5%	2.6%	4903	4257	646	4088	3529	559	1.3%	1.2%	2.6%	0.002668	0.002490	0.000874	0.000868	0.002801	
2	0.85	3	237563	1506	1424	0.63%	0.60%	81863	60036	21827	3396	2750	646	2663	2104	559	4.1%	4.6%	3.0%	3.3%	3.5%	2.6%	4902	4256	646	4087	3528	559	1.3%	1.2%	2.6%	0.002649	0.002526	0.000893	0.000857	0.005172	
2	0.9	3	237990	1508	1425	0.63%	0.60%	82017	60134	21883	3396	2750	646	2663	2104	559	4.1%	4.6%	3.0%	3.2%	3.5%	2.6%	4904	4258	646	4088	3529	559	1.3%	1.2%	2.6%	0.002836	0.002084	0.001068	0.001153	0.004097	
2	0.95	3	238048	1509	1426	0.63%	0.60%	82029	60142	21887	3396	2750	646	2663	2104	559	4.1%	4.6%	3.0%	3.2%	3.5%	2.6%	4905	4259	646	4089	3530	559	1.3%	1.2%	2.6%	0.002732	0.002457	0.001070	0.001374	0.003781	
2	0.98	3	237551	1507	1425	0.63%	0.60%	81863	60038	21825	3396	2750	646	2663	2104	559	4.1%	4.6%	3.0%	3.3%	3.5%	2.6%	4903	4257	646	4088	3529	559	1.3%	1.2%	2.6%	0.002977	0.001999	0.000945	0.000886	0.003329	
2	1	4	237644	1495	1416	0.63%	0.60%	81965	60100	21865	3396	2749	647	2663	2103	560	4.1%	4.6%	3.0%	3.2%	3.5%	2.6%	4891	4244	647	4079	3519	560	1.3%	1.2%	2.6%	0.003023	0.002301	0.000903	0.001000	0.003478	
3	0.1	0	235922	1470	1404	0.62%	0.60%	81105	59525	21580	3391	2745	646	2664	2105	559	4.2%	4.6%	3.0%	3.3%	3.5%	2.6%	4861	4215	646	4068	3509	559	1.3%	1.2%	2.6%	0.002184	0.000539	0.000772	0.000941	0.003067	
3	0.25	2	238006	1505	1424	0.63%	0.60%	81966	60122	21844	3398	2751	647	2665	2105	560	4.1%	4.6%	3.0%	3.3%	3.5%	2.6%	4903	4256	647	4089	3529	560	1.3%	1.2%	2.6%	0.002348	0.002196	0.000926	0.001146	0.003798	
3	0.5	4	238572	1506	1424	0.63%	0.60%	82236	60311	21925	3398	2751	647	2665	2105	560	4.1%	4.6%	3.0%	3.2%	3.5%	2.6%	4904	4257	647	4089	3529	560	1.3%	1.2%	2.6%	0.002472	0.001984	0.000909	0.001464	0.003663	
3	0.65	5	238880	1508	1425	0.63%	0.60%	82356	60386	21970	3398	2751	647	2665	2105	560	4.1%	4.6%	2.9%	3.2%	3.5%	2.5%	4906	4259	647	4090	3530	560	1.3%	1.2%	2.5%	0.002511	0.001744	0.000938	0.000982	0.003831	
3	0.75	6	239644	1508	1425	0.63%	0.59%	82668	60601	22067	3399	2751	648	2666	2105	561	4.1%	4.5%	2.9%	3.2%	3.5%	2.5%	4907	4259	648	4091	3530	561	1.3%	1.2%	2.5%	0.003111	0.001995	0.001336	0.001177	0.004048	
3	0.85	6	239394	1508	1425	0.63%	0.60%	82586	60548	22038	3399	2751	648	2666	2105	561	4.1%	4.5%	2.9%	3.2%	3.5%	2.5%	4907	4259	648	4091	3530	561	1.3%	1.2%	2.5%	0.002652	0.002379	0.001913	0.000894	0.003509	
3	0.9	7	239925	1510	1426	0.63%	0.59%	82803	60691	22112	3399	2751	648	2666	2105	561	4.1%	4.5%	2.9%	3.2%	3.5%	2.5%	4909	4261	648	4092	3531	561	1.3%	1.2%	2.5%	0.002843	0.002498	0.001018	0.001301	0.003349	
3	0.95	7	239527	1510	1426	0.63%	0.60%	82657	60597	22060	3399	2751	648	2666	2105	561	4.1%	4.5%	2.9%	3.2%	3.5%	2.5%	4909	4261	648	4092	3531	561	1.3%	1.2%	2.5%	0.002789	0.002993	0.000913	0.000847	0.003091	
3	0.98	7	239928	1508	1425	0.63%	0.59%	82801	60692	22109	3399	2751	648	2666	2105	561	4.1%	4.5%	2.9%	3.2%	3.5%	2.5%	4907	4259	648	4091	3530	561	1.3%	1.2%	2.5%	0.002728	0.002096	0.001159	0.001668	0.003616	
3	1	8	239659	1494	1415	0.62%	0.59%	82828	60721	22107	3398	2750	648	2665	2104	561	4.1%	4.5%	2.9%	3.2%	3.5%	2.5%	4892	4244	648	4080	3519	561	1.3%	1.2%	2.5%	0.003681	0.002843	0.000945	0.000883	0.002660	
4	0.1	1	238695	1506	1424	0.63%	0.60%	82154	60271	21883	3399	2751	648	2666	2105	561	4.1%	4.6%	3.0%	3.2%	3.5%	2.6%	4905	4257	648	4090	3529	561	1.3%	1.2%	2.6%	0.003640	0.001763	0.000645	0.000858	0.002568	
4	0.25	4	239574	1506	1424	0.63%	0.59%	82548	60561	21987	3400	2751	649	2667	2105	562	4.1%	4.5%	3.0%	3.2%	3.5%	2.6%	4906	4257	649	4091	3529	562	1.3%	1.2%	2.6%	0.003224	0.002490	0.000919	0.000853	0.003832	
4	0.5	8	241151	1506	1424	0.62%	0.59%	83210	61015	22195	3401	2751	650	2668	2105	563	4.1%	4.5%	2.9%	3.2%	3.4%	2.5%	4907	4257	650	4092	3529	563	1.3%	1.2%	2.5%	0.002769	0.002639	0.000996	0.001018	0.004104	
4	0.65	10	241929	1508	1425	0.62%	0.59%	83532	61233	22299	3401	2751	650	2668	2105	563	4.1%	4.5%	2.9%	3.2%	3.4%	2.5%	4909	4259	650	4093	3530	563	1.3%	1.2%	2.5%	0.002367	0.002125	0.000908	0.001331	0.003434	
4	0.75	12	242634	1506	1424	0.62%	0.59%	83846	61450	22396	3402	2751	651	2669	2105	564	4.1%	4.5%	2.9%	3.2%	3.4%	2.5%	4908	4257	651	4093	3529	564	1.3%	1.2%	2.5%	0.002620	0.001763	0.000974	0.001447	0.003779	
4	0.85	13	242923	1506	1424	0.62%	0.59%	83981	61543	22438	3402	2751	651	2669	2105	564	4.1%	4.5%	2.9%	3.2%	3.4%	2.5%	4908	4257	651	4093	3529	564	1.3%	1.2%	2.5%	0.002676	0.001880	0.000896	0.001420	0.002994	
4	0.9	14	243372	1510	1426	0.62%	0.59%	84207	61705	22502	3402	2751	651	2669	2105	564	4.0%	4.5%	2.9%	3.2%	3.4%	2.5%	4912	4261	651	4095	3531	564	1.3%	1.2%	2.5%	0.003027	0.003557	0.001390	0.000898	0.003416	
4	0.95	15	243763	1509	1425	0.62%	0.58%	84351	61800	22551	3402	2751	651	2669	2105	564	4.0%	4.5%	2.9%	3.2%	3.4%	2.5%	4911	4260	651	4094	3530	564	1.2%	1.2%	2.5%	0.002865	0.002845	0.001128	0.000897	0.003911	
4	0.98	15	243498	1508	1425	0.62%	0.59%	84264	61747	22517	3402	2751	651	2669	2105	564	4.0%	4.5%	2.9%	3.2%	3.4%	2.5%	4910	4259	651	4094	3530	564	1.2%	1.2%	2.5%	0.002970	0.002802	0.000928	0.000839	0.003306	
4	1	16	243968	1496	1417	0.61%	0.58%	84587	61975	22612	3402	2750	652	2669	2104	565	4.0%	4.4%	2.9%	3.2%	3.4%	2.5%	4898	4246	652	4086	3521	565	1.2%	1.2%	2.5%	0.003011	0.002328	0.000955	0.000847	0.002730	
5	0.1	3	241495	1509	1423	0.62%	0.59%	83137	61013	22124	3404	2753	651	2670	2106	564	4.1%	4.5%	2.9%	3.2%	3.5%	2.5%	4913	4262	651	4093	3529	564	1.3%	1.2%	2.5%	0.002530	0.002253	0.000900	0.000849	0.003497	
5	0.25	8	243196	1507	1425	0.62%	0.59%	83865	61523	22342	3404	2752	652	2671	2106	565	4.1%	4.5%	2.9%	3.2%	3.4%	2.5%	4911	4259	652	4096	3531	565	1.3%	1.2%	2.5%	0.003247	0.002019	0.000902	0.000892	0.003082	
5	0.5	16	245882	1507	1425	0.61%	0.58%	85052	62341	22711	3406	2752	654	2673	2106	567	4.0%	4.4%	2.9%	3.1%	3.4%	2.5%	4913	4259	654	4098	3531	567	1.2%	1.1%	2.5%	0.003054	0.001741	0.000915	0.000878	0.003232	
5	0.65	20	247297	1509	1426	0.61%	0.58%	85660	62767	22893	3407	2752	655	2674	2106	568	4.0%	4.4%	2.9%	3.1%	3.4%	2.5%	4916	4261	655	4100	3532	568	1.2%	1.1%	2.5%	0.003038	0.001805	0.000903	0.000875	0.003710	
5	0.75	24	248995	1506	1423	0.60%	0.57%	86387	63269	23118	3408	2752	656	2675	2106	569	3.9%	4.3%	2.8%	3.1%	3.3%	2.5%	4914	4258	656	4098	3529	569	1.2%	1.1%	2.5%	0.002835	0.002056	0.001305	0.001359	0.003376	
5	0.85	27	249822	1510	1427	0.60%	0.57%	86781	63540	23241	3409	2752	657	2676	2106	570	3.9%	4.3%	2.8%	3.1%	3.3%	2.5%	4919	4262	657	4103	3533	570	1.2%	1.1%	2.5%	0.002882	0.002010	0.001490	0.000890	0.003594	
5	0.9	28	250094	1511	1427	0.60%	0.57%	86946	63663	23283	3409	2752	657	2676	2106	570	3.9%	4.3%	2.8%	3.1%	3.3%	2.4%	4920	4263	657	4103	3533	570	1.2%	1.1%	2.4%	0.003129	0.002100	0.000919	0.000886	0.003784	
5	0.95	30	250735	1511	1427	0.60%	0.57%	87222	63851	23371	3410	2752	658	2677	2106	571	3.9%	4.3%	2.8%	3.1%	3.3%	2.4%	4921	4263	658	4104	3533	571	1.2%	1.1%	2.4%	0.003614	0.002339	0.000977	0.000855	0.003032	
5	0.98	31	251041	1510	1427	0.60%	0.57%	87369	63954	23415	3410	2752	658	2677	2106	571	3.9%	4.3%	2.8%	3.1%	3.3%	2.4%	4920	4262	658	4104	3533	571	1.2%	1.1%	2.4%	0.002930	0.002452	0.000937	0.000894	0.004491	
5	1	32	251537	1496	1417	0.59%	0.56%	87681	64173	23508	3409	2751	658	2676	2105	571	3.9%	4.3%	2.8%	3.1%	3.3%	2.4%	4905	4247	658	4093	3522	571	1.2%	1.1%	2.4%	0.002974	0.002560	0.001459	0.000928	0.002734	
6	0.1	6	247185	1513	1426	0.61%	0.58%	85090	62467	22623	3409	2752	657	2676	2106	570	4.0%	4.4%	2.9%	3.1%	3.4%	2.5%	4922	4265	657	4102	3532	570	1.2%	1.1%	2.5%	0.002828	0.001910	0.000909	0.000959	0.003747	
6	0.25	16	250629	1507	1425	0.60%	0.57%	86571	63485	23086	3411	2752	659	2678	2106	572	3.9%	4.3%	2.9%	3.1%	3.3%	2.5%	4918	4259	659	4103	3531	572	1.2%	1.1%	2.5%	0.002377	0.001728	0.000961	0.001207	0.003450	
6	0.5	32	255837	1507	1425	0.59%	0.56%	88894	65087	23807	3415	2752	663	2682	2106	576	3.8%	4.2%	2.8%	3.0%	3.2%	2.4%	4922	4259	663	4107	3531	576	1.2%	1.1%	2.4%	0.002354	0.001800	0.001051	0.001540	0.004940	
6	0.65	41	258228	1511	1427	0.59%	0.55%	90029	65883	24146	3417	2752	665	2684	2106	578	3.8%	4.2%	2.8%	3.0%	3.2%	2.4%	4928	4263	665	4111	3533	578	1.2%	1.1%	2.4%	0.002834	0.002490	0.000923	0.000877	0.003102	
6	0.75	48	260795	1509	1426	0.58%	0.55%	91135	66644	24491	3419	2752	667	2686	2106	580	3.8%	4.1%	2.7%	2.9%	3.2%	2.4%	4928	4261	667	4112	3532	580	1.2%	1.1%	2.4%	0.003363	0.002633	0.001065	0.000865	0.003267	
6	0.85	54	262469	1509	1426	0.57%	0.54%	91913	67187	24726	3421	2752	669	2688	2106	582	3.7%	4.1%	2.7%	2.9%	3.1%	2.4%	4930	4261	669	4114	3532	582	1.2%	1.1%	2.4%	0.003484	0.002021	0.000966	0.000905	0.003023	
6	0.9	57	263732	1511	1427	0.57%	0.54%	92505	67602	24903	3421	2752	669	2688	2106	582	3.7%	4.1%	2.7%	2.9%	3.1%	2.3%	4932	4263	669	4115	3533	582	1.2%	1.1%	2.3%	0.002971	0.002570	0.000908	0.000985	0.002853	
6	0.95	60	264969	1511	1427	0.57%	0.54%	93058	67988	25070	3422	2752	670	2689	2106	583	3.7%	4.0%	2.7%	2.9%	3.1%	2.3%	4933	4263	670	4116	3533	583	1.1%	1.1%	2.3%	0.002667	0.003259	0.000913	0.000835	0.002958	
6	0.98	62	266637	1511	1428	0.57%	0.54%	93788	68498	25290	3423	2752	671	2690	2106	584	3.6%	4.0%	2.7%	2.9%	3.1%	2.3%	4934	4263	671	4118	3534	584	1.1%	1.1%	2.3%	0.002840	0.002419	0.001759	0.001011	0.003456	
6	1	64	266747	1498	1419	0.56%	0.53%	93992	68649	25343	3422	2751	671	2689	2105	584	3.6%	4.0%	2.6%	2.9%	3.1%	2.3%	4920	4249	671	4108	3524	584	1.1%	1.1%	2.3%	0.003000	0.002953	0.000928	0.000867	0.002707	
7	0.1	12	258253	1505	1420	0.58%	0.55%	88893	65298	23595	3420	2752	668	2687	2106	581	3.8%	4.2%	2.8%	3.0%	3.2%	2.5%	4925	4257	668	4107	3526	581	1.2%	1.1%	2.5%	0.002429	0.001725	0.000878	0.001411	0.003829	
7	0.25	32	264414	1502	1422	0.57%	0.54%	91631	67188	24443	3425	2752	673	2692	2106	586	3.7%	4.1%	2.8%	2.9%	3.1%	2.4%	4927	4254	673	4114	3528	586	1.2%	1.1%	2.4%	0.002381	0.002076	0.001546	0.000883	0.003311	
7	0.5	64	274676	1502	1422	0.55%	0.52%	96212	70351	25861	3433	2752	681	2700	2106	594	3.6%	3.9%	2.6%	2.8%	3.0%	2.3%	4935	4254	681	4122	3528	594	1.1%	1.0%	2.3%	0.002478	0.002018	0.001044	0.001533	0.003444	
7	0.65	83	280209	1503	1422	0.54%	0.51%	98702	72060	26642	3439	2753	686	2705	2106	599	3.5%	3.8%	2.6%	2.7%	2.9%	2.2%	4942	4256	686	4127	3528	599	1.1%	1.0%	2.2%	0.002372	0.002955	0.000940	0.000855	0.004400	
7	0.75	96	284952	1504	1423	0.53%	0.50%	100836	73551	27285	3442	2753	689	2708	2106	602	3.4%	3.7%	2.5%	2.7%	2.9%	2.2%	4946	4257	689	4131	3529	602	1.1%	1.0%	2.2%	0.002908	0.002048	0.001681	0.000900	0.003925	
7	0.85	108	289163	1504	1423	0.52%	0.49%	102740	74880	27860	3445	2753	692	2711	2106	605	3.4%	3.7%	2.5%	2.6%	2.8%	2.2%	4949	4257	692	4134	3529	605	1.1%	1.0%	2.2%	0.002661	0.002157	0.000956	0.001073	0.003981	
7	0.9	115	291913	1506	1424	0.52%	0.49%	103967	75726	28241	3447	2753	694	2713	2106	607	3.3%	3.6%	2.5%	2.6%	2.8%	2.1%	4953	4259	694	4137	3530	607	1.0%	1.0%	2.1%	0.002620	0.002488	0.001245	0.001302	0.003164	
7	0.95	121	294240	1506	1424	0.51%	0.48%	105090	76528	28562	3448	2753	695	2714	2106	608	3.3%	3.6%	2.4%	2.6%	2.8%	2.1%	4954	4259	695	4138	3530	608	1.0%	1.0%	2.1%	0.002786	0.002144	0.000970	0.000936	0.003553	
7	0.98	125	297245	1506	1425	0.51%	0.48%	106528	77563	28965	3449	2753	696	2715	2106	609	3.2%	3.5%	2.4%	2.5%	2.7%	2.1%	4955	4259	696	4140	3531	609	1.0%	0.9%	2.1%	0.002724	0.004716	0.000993	0.000994	0.004796	
7	1	128	298675	1493	1416	0.50%	0.47%	107303	78114	29189	3449	2752	697	2715	2105	610	3.2%	3.5%	2.4%	2.5%	2.7%	2.1%	4942	4245	697	4131	3521	610	1.0%	0.9%	2.1%	0.003824	0.002964	0.000939	0.000854	0.002951	
8	0.1	25	280577	1508	1423	0.54%	0.51%	96616	71082	25534	3444	2753	691	2710	2106	604	3.6%	3.9%	2.7%	2.8%	3.0%	2.4%	4952	4261	691	4133	3529	604	1.1%	1.0%	2.4%	0.002325	0.001972	0.001024	0.001157	0.003834	
8	0.25	64	292645	1502	1422	0.51%	0.49%	102052	74859	27193	3454	2753	701	2720	2106	614	3.4%	3.7%	2.6%	2.7%	2.8%	2.3%	4956	4255	701	4142	3528	614	1.0%	1.0%	2.3%	0.002383	0.002516	0.001033	0.000909	0.003882	
8	0.5	128	312752	1502	1422	0.48%	0.45%	111063	81085	29978	3472	2755	717	2736	2106	630	3.1%	3.4%	2.4%	2.5%	2.6%	2.1%	4974	4257	717	4158	3528	630	1.0%	0.9%	2.1%	0.002439	0.002828	0.001396	0.000895	0.004063	
8	0.65	166	324948	1506	1424	0.46%	0.44%	116473	84797	31676	3482	2755	727	2746	2106	640	3.0%	3.2%	2.3%	2.4%	2.5%	2.0%	4988	4261	727	4170	3530	640	0.9%	0.9%	2.0%	0.002748	0.002089	0.001867	0.000923	0.003192	
8	0.75	192	333471	1504	1423	0.45%	0.43%	120318	87467	32851	3488	2755	733	2752	2106	646	2.9%	3.1%	2.2%	2.3%	2.4%	2.0%	4992	4259	733	4175	3529	646	0.9%	0.8%	2.0%	0.002741	0.002131	0.000974	0.001483	0.005224	
8	0.85	217	341475	1504	1423	0.44%	0.42%	123906	89938	33968	3494	2755	739	2758	2106	652	2.8%	3.1%	2.2%	2.2%	2.3%	1.9%	4998	4259	739	4181	3529	652	0.9%	0.8%	1.9%	0.002829	0.002935	0.001093	0.000954	0.003097	
8	0.9	230	345701	1506	1424	0.44%	0.41%	125819	91261	34558	3498	2755	743	2762	2106	656	2.8%	3.0%	2.2%	2.2%	2.3%	1.9%	5004	4261	743	4186	3530	656	0.9%	0.8%	1.9%	0.002800	0.002083	0.001686	0.000856	0.004274	
8	0.95	243	352916	1508	1426	0.43%	0.40%	129140	93613	35527	3501	2755	746	2765	2106	659	2.7%	2.9%	2.1%	2.1%	2.2%	1.9%	5009	4263	746	4191	3532	659	0.9%	0.8%	1.9%	0.003202	0.002457	0.001019	0.001458	0.003319	
8	0.98	250	357242	1507	1426	0.42%	0.40%	131150	95047	36103	3503	2755	748	2767	2106	661	2.7%	2.9%	2.1%	2.1%	2.2%	1.8%	5010	4262	748	4193	3532	661	0.9%	0.8%	1.8%	0.002834	0.002276	0.001004	0.001047	0.003617	
8	1	256	365154	1493	1416	0.41%	0.39%	135114	97976	37138	3503	2754	749	2767	2105	662	2.6%	2.8%	2.0%	2.0%	2.1%	1.8%	4996	4247	749	4183	3521	662	0.8%	0.8%	1.8%	0.003694	0.002578	0.000996	0.000910	0.003916	
9	0.1	51	324402	1508	1423	0.46%	0.44%	111790	82464	29326	3495	2757	738	2757	2106	651	3.1%	3.3%	2.5%	2.5%	2.6%	2.2%	5003	4265	738	4180	3529	651	1.0%	0.9%	2.2%	0.002457	0.001995	0.000958	0.000815	0.004378	
9	0.25	128	348734	1503	1423	0.43%	0.41%	122674	89991	32683	3515	2758	757	2776	2106	670	2.9%	3.1%	2.3%	2.3%	2.3%	2.0%	5018	4261	757	4199	3529	670	0.9%	0.8%	2.0%	0.003185	0.001881	0.000960	0.000914	0.003205	
9	0.5	256	389034	1504	1423	0.39%	0.37%	140713	102440	38273	3556	2767	789	2808	2106	702	2.5%	2.7%	2.1%	2.0%	2.1%	1.8%	5060	4271	789	4231	3529	702	0.8%	0.7%	1.8%	0.003812	0.002179	0.001001	0.000884	0.005514	
9	0.65	332	413106	1505	1423	0.36%	0.34%	151488	109875	41613	3575	2767	808	2827	2106	721	2.4%	2.5%	1.9%	1.9%	1.9%	1.7%	5080	4272	808	4250	3529	721	0.8%	0.7%	1.7%	0.002827	0.003198	0.001307	0.000873	0.003636	
9	0.75	384	429839	1504	1423	0.35%	0.33%	159008	115077	43931	3590	2769	821	2840	2106	734	2.3%	2.4%	1.9%	1.8%	1.8%	1.7%	5094	4273	821	4263	3529	734	0.7%	0.6%	1.7%	0.002892	0.003393	0.001077	0.000833	0.003434	
9	0.85	435	448591	1503	1422	0.34%	0.32%	167497	120979	46518	3607	2773	834	2853	2106	747	2.2%	2.3%	1.8%	1.7%	1.7%	1.6%	5110	4276	834	4275	3528	747	0.7%	0.6%	1.6%	0.003176	0.002810	0.001031	0.001018	0.003545	
9	0.9	460	457631	1505	1423	0.33%	0.31%	171573	123807	47766	3627	2787	840	2859	2106	753	2.1%	2.3%	1.8%	1.7%	1.7%	1.6%	5132	4292	840	4282	3529	753	0.7%	0.6%	1.6%	0.003050	0.002559	0.001050	0.001434	0.003958	
9	0.95	486	470398	1508	1426	0.32%	0.30%	177478	127982	49496	3635	2788	847	2866	2106	760	2.0%	2.2%	1.7%	1.6%	1.6%	1.5%	5143	4296	847	4292	3532	760	0.7%	0.6%	1.5%	0.002879	0.002534	0.001171	0.001273	0.003306	
9	0.98	501	477921	1506	1425	0.32%	0.30%	181018	130504	50514	3638	2788	850	2869	2106	763	2.0%	2.1%	1.7%	1.6%	1.6%	1.5%	5144	4294	850	4294	3531	763	0.7%	0.6%	1.5%	0.002938	0.002537	0.001483	0.000946	0.003499	
9	1	512	493886	1493	1416	0.30%	0.29%	188724	136113	52611	3639	2786	853	2871	2105	766	1.9%	2.0%	1.6%	1.5%	1.5%	1.5%	5132	4279	853	4287	3521	766	0.6%	0.6%	1.5%	0.003247	0.002866	0.001772	0.000900	0.003579	
10	0.1	102	413326	1511	1424	0.37%	0.34%	142548	105498	37050	3610	2775	835	2850	2106	744	2.5%	2.6%	2.3%	2.0%	2.0%	2.0%	5121	4286	835	4274	3530	744	0.8%	0.7%	2.0%	0.002603	0.001795	0.001477	0.001643	0.003532	
10	0.25	256	461461	1504	1422	0.33%	0.31%	164102	120379	43723	3670	2794	876	2888	2106	782	2.2%	2.3%	2.0%	1.8%	1.7%	1.8%	5174	4298	876	4310	3528	782	0.7%	0.6%	1.8%	0.002563	0.002007	0.001655	0.001793	0.003817	
10	0.5	512	541692	1505	1423	0.28%	0.26%	200035	145173	54862	3824	2884	940	2952	2106	846	1.9%	2.0%	1.7%	1.5%	1.5%	1.5%	5329	4389	940	4375	3529	846	0.6%	0.5%	1.5%	0.002571	0.002465	0.001297	0.001501	0.004554	
10	0.65	665	590968	1509	1425	0.26%	0.24%	222191	160516	61675	4040	3042	998	2990	2106	884	1.8%	1.9%	1.6%	1.3%	1.3%	1.4%	5549	4551	998	4415	3531	884	0.5%	0.5%	1.4%	0.003295	0.002535	0.001134	0.001024	0.003518	
10	0.75	768	625253	1507	1424	0.24%	0.23%	237695	171289	66406	4134	3105	1029	3016	2106	910	1.7%	1.8%	1.5%	1.3%	1.2%	1.4%	5641	4612	1029	4440	3530	910	0.5%	0.4%	1.4%	0.003090	0.003337	0.001158	0.000959	0.003460	
10	0.85	870	659654	1507	1424	0.23%	0.22%	253184	182024	71160	4296	3223	1073	3042	2106	936	1.7%	1.8%	1.5%	1.2%	1.2%	1.3%	5803	4730	1073	4466	3530	936	0.5%	0.4%	1.3%	0.004169	0.002855	0.001168	0.001064	0.004429	
10	0.9	921	676665	1509	1425	0.22%	0.21%	260884	187360	73524	4398	3293	1105	3054	2106	948	1.7%	1.8%	1.5%	1.2%	1.1%	1.3%	5907	4802	1105	4479	3531	948	0.5%	0.4%	1.3%	0.003051	0.002653	0.001182	0.000908	0.004773	
10	0.95	972	693896	1509	1425	0.22%	0.21%	268621	192712	75909	4501	3371	1130	3067	2106	961	1.7%	1.7%	1.5%	1.1%	1.1%	1.3%	6010	4880	1130	4492	3531	961	0.5%	0.4%	1.3%	0.003476	0.004624	0.001236	0.000864	0.003672	
10	0.98	1003	715124	1511	1428	0.21%	0.20%	278571	199821	78750	4539	3397	1142	3075	2106	969	1.6%	1.7%	1.5%	1.1%	1.1%	1.2%	6050	4908	1142	4503	3534	969	0.5%	0.4%	1.2%	0.003901	0.003303	0.001237	0.000855	0.005669	
10	1	1024	742129	1495	1417	0.20%	0.19%	291618	209237	82381	4526	3383	1143	3079	2105	974	1.6%	1.6%	1.4%	1.1%	1.0%	1.2%	6021	4878	1143	4496	3522	974	0.4%	0.4%	1.2%	0.003849	0.002974	0.001258	0.000898	0.004681	
11	0.1	204	591317	1509	1423	0.26%	0.24%	205439	151137	54302	4076	2968	1108	3035	2106	929	2.0%	2.0%	2.0%	1.5%	1.4%	1.7%	5585	4477	1108	4458	3529	929	0.6%	0.5%	1.7%	0.002530	0.001873	0.001000	0.000933	0.004719	
11	0.25	512	687759	1502	1421	0.22%	0.21%	248569	180869	67700	4896	3556	1340	3112	2106	1006	2.0%	2.0%	2.0%	1.3%	1.2%	1.5%	6398	5058	1340	4533	3527	1006	0.5%	0.4%	1.5%	0.003791	0.002073	0.001470	0.000867	0.004914	
11	0.5	1024	848094	1505	1423	0.18%	0.17%	320378	230400	89978	6141	4491	1650	3240	2106	1134	1.9%	1.9%	1.8%	1.0%	0.9%	1.3%	7646	5996	1650	4663	3529	1134	0.4%	0.3%	1.3%	0.002971	0.003210	0.002235	0.000841	0.004639	
11	0.65	1331	945778	1506	1423	0.16%	0.15%	364187	260664	103523	6976	5171	1805	3317	2106	1211	1.9%	2.0%	1.7%	0.9%	0.8%	1.2%	8482	6677	1805	4740	3529	1211	0.4%	0.3%	1.2%	0.003183	0.006329	0.001526	0.000874	0.004619	
11	0.75	1536	1011357	1504	1422	0.15%	0.14%	393628	281049	112579	7568	5653	1915	3368	2106	1262	1.9%	2.0%	1.7%	0.9%	0.7%	1.1%	9072	7157	1915	4790	3528	1262	0.3%	0.3%	1.1%	0.003704	0.003351	0.001839	0.001283	0.005891	
11	0.85	1740	1086610	1503	1421	0.14%	0.13%	427859	304939	122920	8172	6154	2018	3419	2106	1313	1.9%	2.0%	1.6%	0.8%	0.7%	1.1%	9675	7657	2018	4840	3527	1313	0.3%	0.3%	1.1%	0.003476	0.002996	0.001601	0.001184	0.005316	
11	0.9	1843	1126343	1508	1425	0.13%	0.13%	446005	317630	128375	8470	6390	2080	3445	2106	1339	1.9%	2.0%	1.6%	0.8%	0.7%	1.0%	9978	7898	2080	4870	3531	1339	0.3%	0.2%	1.0%	0.003522	0.003255	0.001549	0.001289	0.004627	
11	0.95	1945	1168027	1508	1425	0.13%	0.12%	465072	330994	134078	8772	6643	2129	3470	2106	1364	1.9%	2.0%	1.6%	0.7%	0.6%	1.0%	10280	8151	2129	4895	3531	1364	0.3%	0.2%	1.0%	0.003434	0.004993	0.001599	0.001010	0.004455	
11	0.98	2007	1210726	1507	1425	0.12%	0.12%	485056	345301	139755	8973	6810	2163	3486	2106	1380	1.8%	2.0%	1.5%	0.7%	0.6%	1.0%	10480	8317	2163	4911	3531	1380	0.3%	0.2%	1.0%	0.003733	0.004725	0.001801	0.001694	0.005685	
11	1	2048	1288521	1494	1416	0.12%	0.11%	523846	374860	148986	9126	6947	2179	3495	2105	1390	1.7%	1.9%	1.5%	0.7%	0.6%	0.9%	10620	8441	2179	4911	3521	1390	0.3%	0.2%	0.9%	0.004930	0.004957	0.001926	0.001005	0.005353	
12	0.1	409	948796	1508	1422	0.16%	0.15%	330395	243487	86908	7098	4641	2457	3406	2106	1300	2.1%	1.9%	2.8%	1.0%	0.9%	1.5%	8606	6149	2457	4828	3528	1300	0.4%	0.3%	1.5%	0.003639	0.002170	0.001176	0.000815	0.005902	
12	0.25	1024	1141470	1502	1421	0.13%	0.12%	416573	302893	113680	12037	8059	3978	3560	2106	1454	2.9%	2.7%	3.5%	0.9%	0.7%	1.3%	13539	9561	3978	4981	3527	1454	0.3%	0.2%	1.3%	0.002925	0.002470	0.001665	0.001296	0.006516	
12	0.5	2048	1462570	1503	1422	0.10%	0.10%	560520	402308	158212	20418	13909	6509	3816	2106	1710	3.6%	3.5%	4.1%	0.7%	0.5%	1.1%	21921	15412	6509	5238	3528	1710	0.3%	0.2%	1.1%	0.003062	0.003160	0.002190	0.001108	0.005803	
12	0.65	2662	1656691	1506	1423	0.09%	0.09%	647599	462453	185146	25449	17493	7956	3970	2106	1864	3.9%	3.8%	4.3%	0.6%	0.5%	1.0%	26955	18999	7956	5393	3529	1864	0.2%	0.2%	1.0%	0.003968	0.004043	0.002322	0.000958	0.005584	
12	0.75	3072	1796121	1504	1422	0.08%	0.08%	710561	506158	204403	28779	20051	8728	4072	2106	1966	4.1%	4.0%	4.3%	0.6%	0.4%	1.0%	30283	21555	8728	5494	3528	1966	0.2%	0.2%	1.0%	0.003797	0.004257	0.002005	0.000939	0.005673	
12	0.85	3481	1935020	1503	1421	0.08%	0.07%	773310	549725	223585	32061	22579	9482	4174	2106	2068	4.1%	4.1%	4.2%	0.5%	0.4%	0.9%	33564	24082	9482	5595	3527	2068	0.2%	0.1%	0.9%	0.005083	0.003967	0.002281	0.000904	0.009760	
12	0.9	3686	2009785	1505	1422	0.07%	0.07%	807313	573445	233868	33815	23995	9820	4226	2106	2120	4.2%	4.2%	4.2%	0.5%	0.4%	0.9%	35320	25500	9820	5648	3528	2120	0.2%	0.1%	0.9%	0.004659	0.004445	0.006176	0.001065	0.006351	
12	0.95	3891	2093938	1508	1425	0.07%	0.07%	845993	600574	245419	35319	25233	10086	4277	2106	2171	4.2%	4.2%	4.1%	0.5%	0.4%	0.9%	36827	26741	10086	5702	3531	2171	0.2%	0.1%	0.9%	0.004518	0.005272	0.007284	0.000958	0.007304	
12	0.98	4014	2165599	1506	1424	0.07%	0.07%	879437	624308	255129	36526	26142	10384	4308	2106	2202	4.2%	4.2%	4.1%	0.5%	0.3%	0.9%	38032	27648	10384	5732	3530	2202	0.2%	0.1%	0.9%	0.004358	0.004449	0.003604	0.000935	0.006238	
12	1	4096	2270399	1493	1415	0.07%	0.06%	931162	662985	268177	37712	27201	10511	4327	2105	2222	4.0%	4.1%	3.9%	0.5%	0.3%	0.8%	39205	28694	10511	5742	3520	2222	0.2%	0.1%	0.8%	0.005190	0.006017	0.002787	0.000989	0.006589	
13	0.1	819	1656448	1521	1432	0.09%	0.09%	577992	425888	152104	13163	8424	4739	4148	2106	2042	2.3%	2.0%	3.1%	0.7%	0.5%	1.3%	14684	9945	4739	5580	3538	2042	0.2%	0.2%	1.3%	0.003382	0.002505	0.001575	0.000870	0.009174	
13	0.25	2048	2042136	1514	1431	0.07%	0.07%	750822	545235	205587	26303	17715	8588	4456	2106	2350	3.5%	3.2%	4.2%	0.6%	0.4%	1.1%	27817	19229	8588	5887	3537	2350	0.2%	0.1%	1.1%	0.003223	0.003456	0.001728	0.001449	0.008427	
13	0.5	4096	2684145	1514	1431	0.06%	0.05%	1038608	743952	294656	48472	33436	15036	4968	2106	2862	4.7%	4.5%	5.1%	0.5%	0.3%	1.0%	49986	34950	15036	6399	3537	2862	0.2%	0.1%	1.0%	0.003966	0.004434	0.007050	0.001072	0.009260	
13	0.65	5324	3078248	1517	1433	0.05%	0.05%	1215642	866394	349248	61652	43169	18483	5275	2106	3169	5.1%	5.0%	5.3%	0.4%	0.2%	0.9%	63169	44686	18483	6708	3539	3169	0.2%	0.1%	0.9%	0.005719	0.005782	0.002743	0.001516	0.012758	
13	0.75	6144	3341311	1516	1432	0.05%	0.04%	1333801	948103	385698	70754	49917	20837	5480	2106	3374	5.3%	5.3%	5.4%	0.4%	0.2%	0.9%	72270	51433	20837	6912	3538	3374	0.1%	0.1%	0.9%	0.005461	0.005348	0.008243	0.001059	0.010085	
13	0.85	6963	3624452	1515	1431	0.04%	0.04%	1461785	1036949	424836	79592	56735	22857	5684	2106	3578	5.4%	5.5%	5.4%	0.4%	0.2%	0.8%	81107	58250	22857	7115	3537	3578	0.1%	0.1%	0.8%	0.005283	0.008285	0.003603	0.001115	0.011548	
13	0.9	7372	3797689	1516	1432	0.04%	0.04%	1541447	1092907	448540	84455	60903	23552	5786	2105	3681	5.5%	5.6%	5.3%	0.4%	0.2%	0.8%	85971	62419	23552	7218	3537	3681	0.1%	0.1%	0.8%	0.005865	0.007620	0.003897	0.002134	0.009945	
13	0.95	7782	3978167	1519	1435	0.04%	0.04%	1624652	1151472	473180	89236	65049	24187	5889	2106	3783	5.5%	5.6%	5.1%	0.4%	0.2%	0.8%	90755	66568	24187	7324	3541	3783	0.1%	0.1%	0.8%	0.006749	0.007736	0.011068	0.001045	0.011143	
13	0.98	8028	4144737	1520	1436	0.04%	0.03%	1702132	1206996	495136	92627	68104	24523	5951	2106	3845	5.4%	5.6%	5.0%	0.3%	0.2%	0.8%	94147	69624	24523	7387	3542	3845	0.1%	0.1%	0.8%	0.007193	0.012441	0.004145	0.001030	0.011871	
13	1	8192	4451901	1505	1425	0.03%	0.03%	1848671	1314405	534266	96340	71651	24689	5991	2105	3886	5.2%	5.5%	4.6%	0.3%	0.2%	0.7%	97845	73156	24689	7416	3530	3886	0.1%	0.1%	0.7%	0.007095	0.011306	0.005923	0.001160	0.009138	
14	0.1	1638	3069462	1523	1434	0.05%	0.05%	1068509	794269	274240	29271	20755	8516	5273	2222	3051	2.7%	2.6%	3.1%	0.5%	0.3%	1.1%	30794	22278	8516	6707	3656	3051	0.2%	0.1%	1.1%	0.003043	0.006510	0.001741	0.000935	0.014823	
14	0.25	4096	3839880	1515	1432	0.04%	0.04%	1413737	1032581	381156	67570	48084	19486	6245	2107	4138	4.8%	4.7%	5.1%	0.4%	0.2%	1.1%	69085	49599	19486	7677	3539	4138	0.1%	0.1%	1.1%	0.004383	0.004714	0.002571	0.001612	0.022648	
14	0.5	8192	5123869	1516	1433	0.03%	0.03%	1989223	1429916	559307	131490	93833	37657	7269	2106	5163	6.6%	6.6%	6.7%	0.4%	0.1%	0.9%	133006	95349	37657	8702	3539	5163	0.1%	0.1%	0.9%	0.006718	0.008289	0.005361	0.000964	0.015232	
14	0.65	10649	5894812	1517	1434	0.03%	0.02%	2334778	1668554	666224	169678	121113	48565	7883	2106	5777	7.3%	7.3%	7.3%	0.3%	0.1%	0.9%	171195	122630	48565	9317	3540	5777	0.1%	0.0%	0.9%	0.006321	0.009698	0.005004	0.001026	0.016758	
14	0.75	12288	6455779	1517	1433	0.02%	0.02%	2588239	1844526	743713	195160	141030	54130	8292	2105	6187	7.5%	7.6%	7.3%	0.3%	0.1%	0.8%	196677	142547	54130	9725	3538	6187	0.1%	0.0%	0.8%	0.007686	0.013328	0.005388	0.001973	0.016952	
14	0.85	13926	7038305	1519	1435	0.02%	0.02%	2852549	2028566	823983	220639	161362	59277	8702	2106	6596	7.7%	8.0%	7.2%	0.3%	0.1%	0.8%	222158	162881	59277	10137	3541	6596	0.1%	0.0%	0.8%	0.008140	0.014265	0.007145	0.001061	0.017262	
14	0.9	14745	7346458	1518	1434	0.02%	0.02%	2993251	2126881	866370	233647	171789	61858	8906	2105	6801	7.8%	8.1%	7.1%	0.3%	0.1%	0.8%	235165	173307	61858	10340	3539	6801	0.1%	0.0%	0.8%	0.009423	0.013168	0.006558	0.002045	0.017781	
14	0.95	15564	7712632	1521	1437	0.02%	0.02%	3162054	2245699	916355	246725	183038	63687	9112	2106	7006	7.8%	8.2%	7.0%	0.3%	0.1%	0.8%	248246	184559	63687	10549	3543	7006	0.1%	0.0%	0.8%	0.009144	0.015053	0.008344	0.001171	0.017347	
14	0.98	16056	7970831	1521	1437	0.02%	0.02%	3279362	2329125	950237	255155	190683	64472	9235	2106	7129	7.8%	8.2%	6.8%	0.3%	0.1%	0.8%	256676	192204	64472	10672	3543	7129	0.1%	0.0%	0.8%	0.009959	0.015262	0.007734	0.001180	0.019326	
14	1	16384	8730842	1507	1427	0.02%	0.02%	3652742	2607962	1044780	264727	199840	64887	9316	2105	7211	7.2%	7.7%	6.2%	0.3%	0.1%	0.7%	266234	201347	64887	10743	3532	7211	0.1%	0.0%	0.7%	0.011267	0.014993	0.018156	0.001133	0.018586	
15	0.1	3276	5980572	1523	1434	0.03%	0.02%	2079846	1553094	526752	103246	86569	16677	7898	2428	5470	5.0%	5.6%	3.2%	0.4%	0.2%	1.0%	104769	88092	16677	9332	3862	5470	0.1%	0.1%	1.0%	0.004475	0.005405	0.003556	0.001367	0.027100	
15	0.25	8192	7660474	1516	1433	0.02%	0.02%	2813227	2072640	740587	229669	190817	38852	9829	2107	7722	8.2%	9.2%	5.2%	0.3%	0.1%	1.0%	231185	192333	38852	11262	3540	7722	0.1%	0.0%	1.0%	0.005592	0.009139	0.004359	0.001028	0.030287	
15	0.5	16384	10402846	1516	1433	0.01%	0.01%	4017508	2920571	1096937	397514	321642	75872	11877	2107	9770	9.9%	11.0%	6.9%	0.3%	0.1%	0.9%	399030	323158	75872	13310	3540	9770	0.1%	0.0%	0.9%	0.009047	0.017391	0.007650	0.001065	0.033918	
15	0.65	21299	11957726	1519	1435	0.01%	0.01%	4717558	3401879	1315679	470240	374662	95578	13105	2106	10999	10.0%	11.0%	7.3%	0.3%	0.1%	0.8%	471759	376181	95578	14540	3541	10999	0.1%	0.0%	0.8%	0.012155	0.022913	0.010551	0.001228	0.034473	
15	0.75	24576	13000427	1518	1434	0.01%	0.01%	5188165	3725402	1462763	518063	410016	108047	13925	2106	11819	10.0%	11.0%	7.4%	0.3%	0.1%	0.8%	519581	411534	108047	15359	3540	11819	0.1%	0.0%	0.8%	0.013422	0.022314	0.014036	0.001451	0.033735	
15	0.85	27852	14035648	1518	1434	0.01%	0.01%	5655983	4046200	1609783	563998	444002	119996	14744	2106	12638	10.0%	11.0%	7.5%	0.3%	0.1%	0.8%	565516	445520	119996	16178	3540	12638	0.1%	0.0%	0.8%	0.015047	0.020335	0.014337	0.001401	0.034203	
15	0.9	29491	14687985	1519	1435	0.01%	0.01%	5955937	4254990	1700947	587288	463434	123854	15153	2106	13047	9.9%	10.9%	7.3%	0.3%	0.0%	0.8%	588807	464953	123854	16588	3541	13047	0.1%	0.0%	0.8%	0.016402	0.021757	0.014929	0.001347	0.035120	
15	0.95	31129	15470982	1517	1433	0.01%	0.01%	6319642	4510550	1809092	611302	485572	125730	15562	2105	13457	9.7%	10.8%	6.9%	0.2%	0.0%	0.7%	612819	487089	125730	16995	3538	13457	0.1%	0.0%	0.7%	0.020129	0.034577	0.014645	0.002903	0.033745	
15	0.98	32112	16148095	1522	1438	0.01%	0.01%	6637793	4737234	1900559	626885	500028	126857	15809	2106	13703	9.4%	10.6%	6.7%	0.2%	0.0%	0.7%	628407	501550	126857	17247	3544	13703	0.1%	0.0%	0.7%	0.018348	0.025366	0.016458	0.001600	0.034047	
15	1	32768	16906993	1506	1426	0.01%	0.01%	7092205	5148586	1943619	646122	517417	128705	15972	2105	13867	9.1%	10.0%	6.6%	0.2%	0.0%	0.7%	647628	518923	128705	17398	3531	13867	0.1%	0.0%	0.7%	0.022634	0.020665	0.020588	0.001723	0.033409	
16	0.1	6553	11792191	1523	1434	0.01%	0.01%	4099466	3067698	1031768	319277	286772	32505	13127	2631	10496	7.8%	9.3%	3.2%	0.3%	0.1%	1.0%	320800	288295	32505	14561	4065	10496	0.1%	0.0%	1.0%	0.005731	0.008843	0.003837	0.000973	0.050366	
16	0.25	16384	15257370	1516	1433	0.01%	0.01%	5598556	4139123	1459433	527337	450427	76910	16996	2106	14890	9.4%	10.9%	5.3%	0.3%	0.1%	1.0%	528853	451943	76910	18429	3539	14890	0.1%	0.0%	1.0%	0.011155	0.020070	0.008748	0.001202	0.057488	
16	0.5	32768	20814580	1515	1432	0.01%	0.01%	8013660	5841549	2172111	839121	688229	150892	21092	2105	18987	10.5%	11.8%	6.9%	0.3%	0.0%	0.9%	840636	689744	150892	22524	3537	18987	0.1%	0.0%	0.9%	0.018174	0.025046	0.016463	0.003002	0.063698	
16	0.65	42598	24067695	1515	1432	0.01%	0.01%	9434812	6835084	2599728	1014006	818737	195269	23549	2105	21444	10.7%	12.0%	7.5%	0.2%	0.0%	0.8%	1015521	820252	195269	24981	3537	21444	0.1%	0.0%	0.8%	0.022007	0.038813	0.022521	0.002417	0.074610	
16	0.75	49152	26259115	1517	1433	0.01%	0.01%	10415426	7514710	2900716	1116077	895306	220771	25189	2106	23083	10.7%	11.9%	7.6%	0.2%	0.0%	0.8%	1117594	896823	220771	26622	3539	23083	0.1%	0.0%	0.8%	0.032205	0.038789	0.025844	0.001656	0.061241	
16	0.85	55705	28532622	1517	1433	0.01%	0.01%	11453740	8230577	3223163	1207385	966664	240721	26827	2106	24721	10.5%	11.7%	7.5%	0.2%	0.0%	0.8%	1208902	968181	240721	28260	3539	24721	0.1%	0.0%	0.8%	0.029738	0.042644	0.048306	0.001696	0.064451	
16	0.9	58982	29771098	1518	1434	0.01%	0.00%	12021887	8624395	3397492	1253542	1005005	248537	27645	2105	25540	10.4%	11.7%	7.3%	0.2%	0.0%	0.8%	1255060	1006523	248537	29079	3539	25540	0.1%	0.0%	0.8%	0.033885	0.062927	0.031218	0.002888	0.059918	
16	0.95	62259	31106120	1518	1434	0.00%	0.00%	12637516	9053129	3584387	1300055	1045762	254293	28464	2105	26359	10.3%	11.6%	7.1%	0.2%	0.0%	0.7%	1301573	1047280	254293	29898	3539	26359	0.1%	0.0%	0.7%	0.035685	0.057738	0.035602	0.002046	0.059884	
16	0.98	64225	32079794	1522	1438	0.00%	0.00%	13080719	9366331	3714388	1331598	1073915	257683	28957	2106	26851	10.2%	11.5%	6.9%	0.2%	0.0%	0.7%	1333120	1075437	257683	30395	3544	26851	0.1%	0.0%	0.7%	0.036858	0.087960	0.050341	0.001925	0.062494	
16	1	65536	34838199	1503	1423	0.00%	0.00%	14536860	10524097	4012763	1369968	1110035	259933	29283	2104	27179	9.4%	10.5%	6.5%	0.2%	0.0%	0.7%	1371471	1111538	259933	30706	3527	27179	0.1%	0.0%	0.7%	0.045679	0.052917	0.046011	0.002705	0.064085	
17	0.1	13107	22961162	1512	1425	0.01%	0.01%	7994665	5960977	2033688	606517	544431	62086	23526	3207	20319	7.6%	9.1%	3.1%	0.3%	0.1%	1.0%	608029	545943	62086	24951	4632	20319	0.1%	0.0%	1.0%	0.009068	0.014694	0.007083	0.001254	0.096161	
17	0.25	32768	29297276	1506	1424	0.01%	0.00%	10808383	7919452	2888931	943166	792298	150868	31332	2106	29226	8.7%	10.0%	5.2%	0.3%	0.0%	1.0%	944672	793804	150868	32756	3530	29226	0.1%	0.0%	1.0%	0.018155	0.030219	0.016822	0.001518	0.107163	
17	0.5	65536	39820202	1506	1424	0.00%	0.00%	15483326	11169003	4314323	1494924	1196087	298837	39524	2105	37419	9.7%	10.7%	6.9%	0.3%	0.0%	0.9%	1496430	1197593	298837	40948	3529	37419	0.1%	0.0%	0.9%	0.034056	0.052170	0.035303	0.002426	0.111235	
17	0.65	85196	46270171	1508	1425	0.00%	0.00%	18355978	13168678	5187300	1826271	1447543	378728	44439	2105	42334	9.9%	11.0%	7.3%	0.2%	0.0%	0.8%	1827779	1449051	378728	45864	3530	42334	0.1%	0.0%	0.8%	0.046210	0.069262	0.047225	0.002294	0.126960	
17	0.75	98304	50652750	1508	1425	0.00%	0.00%	20312000	14531545	5780455	2046737	1620292	426445	47716	2105	45611	10.1%	11.2%	7.4%	0.2%	0.0%	0.8%	2048245	1621800	426445	49141	3530	45611	0.1%	0.0%	0.8%	0.069063	0.078824	0.051986	0.002370	0.116157	
17	0.85	111411	55029363	1507	1424	0.00%	0.00%	22265505	15891964	6373541	2266021	1791856	474165	50992	2105	48887	10.2%	11.3%	7.4%	0.2%	0.0%	0.8%	2267528	1793363	474165	52416	3529	48887	0.1%	0.0%	0.8%	0.059553	0.091289	0.056206	0.002767	0.120793	
17	0.9	117964	57152052	1509	1426	0.00%	0.00%	23222071	16552000	6670071	2365955	1867931	498024	52631	2105	50526	10.2%	11.3%	7.5%	0.2%	0.0%	0.8%	2367464	1869440	498024	54057	3531	50526	0.1%	0.0%	0.8%	0.059782	0.121795	0.060062	0.002819	0.117926	
17	0.95	124518	60278362	1511	1428	0.00%	0.00%	24671699	17572696	7099003	2471625	1956209	515416	54269	2105	52164	10.0%	11.1%	7.3%	0.2%	0.0%	0.7%	2473136	1957720	515416	55697	3533	52164	0.1%	0.0%	0.7%	0.067385	0.101839	0.070388	0.003618	0.119607	
17	0.98	128450	63020776	1511	1428	0.00%	0.00%	25945589	18483983	7461606	2542467	2020871	521596	55252	2105	53147	9.8%	10.9%	7.0%	0.2%	0.0%	0.7%	2543978	2022382	521596	56680	3533	53147	0.1%	0.0%	0.7%	0.075543	0.106703	0.074495	0.002932	0.123688	
17	1	131072	68560032	1498	1418	0.00%	0.00%	28795232	20730423	8064809	2624954	2098095	526859	55907	2104	53803	9.1%	10.1%	6.5%	0.2%	0.0%	0.7%	2626452	2099593	526859	57325	3522	53803	0.1%	0.0%	0.7%	0.084713	0.106171	0.079416	0.003405	0.121798	
18	0.1	26214	45707578	1497	1410	0.00%	0.00%	15914959	11869341	4045618	1229166	1105850	123316	44366	4322	40044	7.7%	9.3%	3.0%	0.3%	0.0%	1.0%	1230663	1107347	123316	45776	5732	40044	0.1%	0.0%	1.0%	0.014256	0.023582	0.013609	0.001462	0.183462	
18	0.25	65536	58480210	1490	1408	0.00%	0.00%	21575958	15819859	5756099	1912110	1611228	300882	60004	2106	57898	8.9%	10.2%	5.2%	0.3%	0.0%	1.0%	1913600	1612718	300882	61412	3514	57898	0.1%	0.0%	1.0%	0.031562	0.072009	0.039238	0.002945	0.201840	
18	0.5	131072	79746642	1493	1410	0.00%	0.00%	31005227	22395635	8609592	3040344	2444858	595486	76388	2105	74283	9.8%	10.9%	6.9%	0.2%	0.0%	0.9%	3041837	2446351	595486	77798	3515	74283	0.1%	0.0%	0.9%	0.065629	0.111042	0.061996	0.003034	0.242250	
18	0.65	170393	92187801	1493	1410	0.00%	0.00%	36573373	26242530	10330843	3658957	2891349	767608	86218	2105	84113	10.0%	11.0%	7.4%	0.2%	0.0%	0.8%	3660450	2892842	767608	87628	3515	84113	0.1%	0.0%	0.8%	0.087790	0.143501	0.074040	0.004505	0.255312	
18	0.75	196608	100388063	1493	1411	0.00%	0.00%	40259207	28779573	11479634	4057326	3175203	882123	92772	2105	90667	10.1%	11.0%	7.7%	0.2%	0.0%	0.8%	4058819	3176696	882123	94183	3516	90667	0.1%	0.0%	0.8%	0.100511	0.162723	0.085772	0.004773	0.279029	
18	0.85	222822	109979151	1491	1409	0.00%	0.00%	44627220	31816564	12810656	4461765	3510738	951027	99325	2105	97220	10.0%	11.0%	7.4%	0.2%	0.0%	0.8%	4463256	3512229	951027	100734	3514	97220	0.1%	0.0%	0.8%	0.119499	0.180917	0.099834	0.004873	0.278769	
18	0.9	235929	114773036	1491	1410	0.00%	0.00%	46810375	33334287	13476088	4663700	3678208	985492	102602	2105	100497	10.0%	11.0%	7.3%	0.2%	0.0%	0.7%	4665191	3679699	985492	104012	3515	100497	0.1%	0.0%	0.7%	0.131333	0.191516	0.123157	0.005012	0.281029	
18	0.95	249036	120879634	1493	1412	0.00%	0.00%	49643743	35328620	14315123	4874644	3854690	1019954	105879	2105	103774	9.8%	10.9%	7.1%	0.2%	0.0%	0.7%	4876137	3856183	1019954	107291	3517	103774	0.1%	0.0%	0.7%	0.133775	0.207842	0.121287	0.005358	0.287565	
18	0.98	256901	126090370	1494	1413	0.00%	0.00%	52080263	37066998	15013265	5012606	3975660	1036946	107845	2105	105740	9.6%	10.7%	6.9%	0.2%	0.0%	0.7%	5014100	3977154	1036946	109258	3518	105740	0.1%	0.0%	0.7%	0.145388	0.205833	0.126688	0.005486	0.296151	
18	1	262144	133346335	1481	1402	0.00%	0.00%	56585242	41149259	15435983	5187241	4139181	1048060	109155	2104	107051	9.2%	10.1%	6.8%	0.2%	0.0%	0.7%	5188722	4140662	1048060	110557	3506	107051	0.1%	0.0%	0.7%	0.222601	0.167283	0.171782	0.006945	0.329956	
19	0.1	52428	90580655	1498	1411	0.00%	0.00%	31564696	23495182	8069514	2391657	2145872	245785	85713	5469	80244	7.6%	9.1%	3.0%	0.3%	0.0%	1.0%	2393155	2147370	245785	87124	6880	80244	0.1%	0.0%	1.0%	0.026670	0.052833	0.052264	0.001918	0.357571	
19	0.25	131072	115233815	1491	1409	0.00%	0.00%	42612866	31122351	11490515	3632774	3031862	600912	117348	2105	115243	8.5%	9.7%	5.2%	0.3%	0.0%	1.0%	3634265	3033353	600912	118757	3514	115243	0.1%	0.0%	1.0%	0.066068	0.123060	0.061463	0.003142	0.402289	
19	0.5	262144	156326750	1490	1446	0.00%	0.00%	61029931	43837798	17192133	5700922	4508142	1192780	327046	162411	164635	9.3%	10.3%	6.9%	0.5%	0.4%	1.0%	5702412	4509632	1192780	328492	163857	164635	0.2%	0.1%	1.0%	0.129019	0.230986	0.117158	0.005639	0.512064	
19	0.65	340787	181446145	1491	1447	0.00%	0.00%	72308231	51634348	20673883	6942743	5418942	1523801	547114	343155	203959	9.6%	10.5%	7.4%	0.8%	0.7%	1.0%	6944234	5420433	1523801	548561	344602	203959	0.2%	0.1%	1.0%	0.190946	0.280043	0.151842	0.008313	0.538573	
19	0.75	393216	198938220	1490	1446	0.00%	0.00%	80193094	57099838	23093256	7772292	6066729	1705563	706638	476464	230174	9.7%	10.6%	7.4%	0.9%	0.8%	1.0%	7773782	6068219	1705563	708084	477910	230174	0.3%	0.2%	1.0%	0.218337	0.326326	0.184861	0.009233	0.566070	
19	0.85	445644	216479056	1489	1445	0.00%	0.00%	88103875	62585191	25518684	8602969	6715640	1887329	857306	600918	256388	9.8%	10.7%	7.4%	1.0%	1.0%	1.0%	8604458	6717129	1887329	858751	602363	256388	0.3%	0.2%	1.0%	0.262658	0.361289	0.237532	0.009837	0.601127	
19	0.9	471859	225416081	1491	1447	0.00%	0.00%	92144992	65391428	26753564	9019389	7041177	1978212	936551	667057	269494	9.8%	10.8%	7.4%	1.0%	1.0%	1.0%	9020880	7042668	1978212	937998	668504	269494	0.3%	0.2%	1.0%	0.296850	0.396002	0.224573	0.009539	0.692618	
19	0.95	498073	234380843	1492	1448	0.00%	0.00%	96188571	68200233	27988338	9436094	7366999	2069095	1014038	731436	282602	9.8%	10.8%	7.4%	1.1%	1.1%	1.0%	9437586	7368491	2069095	1015486	732884	282602	0.3%	0.2%	1.0%	0.266292	0.411832	0.240536	0.011381	0.641931	
19	0.98	513802	239910669	1491	1447	0.00%	0.00%	98638920	69909656	28729264	9690926	7567306	2123620	1060271	769786	290485	9.8%	10.8%	7.4%	1.1%	1.1%	1.0%	9692417	7568797	2123620	1061718	771233	290485	0.3%	0.2%	1.0%	0.308053	0.425362	0.274928	0.010535	0.622890	
19	1	524288	263383507	1480	1436	0.00%	0.00%	112119429	81372145	30747284	10105447	7947828	2157619	1099303	803571	295732	9.0%	9.8%	7.0%	1.0%	1.0%	1.0%	10106927	7949308	2157619	1100739	805007	295732	0.3%	0.2%	1.0%	0.366691	0.333748	0.336799	0.011261	0.679604	
20	0.1	104857	180922893	1497	1450	0.00%	0.00%	63046736	46929394	16117342	4799042	4308315	490727	495917	231485	264432	7.6%	9.2%	3.0%	0.8%	0.5%	1.6%	4800539	4309812	490727	497367	232935	264432	0.2%	0.1%	1.6%	0.053085	0.119611	0.056373	0.003140	0.780146	
20	0.25	262144	230234317	1487	1443	0.00%	0.00%	85147073	62187772	22959301	7280881	6079912	1200969	1546779	985503	561276	8.6%	9.8%	5.2%	1.8%	1.6%	2.4%	7282368	6081399	1200969	1548222	986946	561276	0.5%	0.3%	2.4%	0.141407	0.252511	0.123690	0.005915	0.902925	
20	0.5	524288	312470375	1494	1450	0.00%	0.00%	122004903	87635272	34369631	11415011	9033855	2381156	3467057	2373292	1093765	9.4%	10.3%	6.9%	2.8%	2.7%	3.2%	11416505	9035349	2381156	3468507	2374742	1093765	0.8%	0.6%	3.2%	0.374290	0.490870	0.259984	0.011553	1.036506	
20	0.65	681574	362629128	1494	1450	0.00%	0.00%	144522505	103200071	41322434	13898075	10862107	3035968	4617646	3217658	1399988	9.6%	10.5%	7.3%	3.2%	3.1%	3.4%	13899569	10863601	3035968	4619096	3219108	1399988	0.9%	0.7%	3.4%	0.402280	0.660354	0.348571	0.012681	1.146207	
20	0.75	786432	396065395	1493	1449	0.00%	0.00%	159531994	113574321	45957673	15552471	12079967	3472504	5402674	3791095	1611579	9.7%	10.6%	7.6%	3.4%	3.3%	3.5%	15553964	12081460	3472504	5404123	3792544	1611579	1.0%	0.7%	3.5%	0.428437	0.742477	0.388996	0.015020	1.211808	
20	0.85	891289	434200541	1492	1448	0.00%	0.00%	176860672	125651342	51209330	17231439	13425786	3805653	6194973	4434406	1760567	9.7%	10.7%	7.4%	3.5%	3.5%	3.4%	17232931	13427278	3805653	6196421	4435854	1760567	1.0%	0.8%	3.4%	0.525219	0.881817	0.438392	0.016777	1.243774	
20	0.9	943718	455076625	1493	1449	0.00%	0.00%	186417500	132345039	54072461	18080272	14147844	3932428	6637137	4781868	1855269	9.7%	10.7%	7.3%	3.6%	3.6%	3.4%	18081765	14149337	3932428	6638586	4783317	1855269	1.0%	0.8%	3.4%	0.542756	0.928822	0.516092	0.019339	1.276859	
20	0.95	996147	477291483	1494	1450	0.00%	0.00%	196643862	139532212	57111650	18938258	14879082	4059176	6997495	5111770	1885725	9.6%	10.7%	7.1%	3.6%	3.7%	3.3%	18939752	14880576	4059176	6998945	5113220	1885725	1.0%	0.8%	3.3%	0.580216	0.982709	0.508351	0.019629	1.342211	
20	0.98	1027604	491122119	1498	1454	0.00%	0.00%	202918984	143959962	58959022	19463387	15328159	4135228	7225725	5323486	1902239	9.6%	10.6%	7.0%	3.6%	3.7%	3.2%	19464885	15329657	4135228	7227179	5324940	1902239	1.0%	0.8%	3.2%	0.664869	1.023544	0.530882	0.020319	1.358452	
20	1	1048576	535582907	1482	1438	0.00%	0.00%	228062820	165466134	62596686	20288888	16118852	4170036	7642758	5721312	1921446	8.9%	9.7%	6.7%	3.4%	3.5%	3.1%	20290370	16120334	4170036	7644196	5722750	1921446	1.0%	0.8%	3.1%	0.765334	0.865903	0.698827	0.021818	1.338327	
21	0.1	209715	361611814	1500	1453	0.00%	0.00%	126014256	93801262	32212994	9614879	8634269	980610	1901266	1235731	665535	7.6%	9.2%	3.0%	1.5%	1.3%	2.1%	9616379	8635769	980610	1902719	1237184	665535	0.4%	0.3%	2.1%	0.121305	0.222401	0.107961	0.004824	1.686426	
21	0.25	524288	460228268	1492	1448	0.00%	0.00%	170210226	124313354	45896872	14575433	12174326	2401107	5279357	3644327	1635030	8.6%	9.8%	5.2%	3.1%	2.9%	3.6%	14576925	12175818	2401107	5280805	3645775	1635030	0.8%	0.6%	3.6%	0.326902	0.540616	0.287874	0.011277	1.890968	
21	0.5	1048576	624595028	1498	1454	0.00%	0.00%	243874632	175171243	68703389	22843067	18074469	4768598	10896252	7657266	3238986	9.4%	10.3%	6.9%	4.5%	4.4%	4.7%	22844565	18075967	4768598	10897706	7658720	3238986	1.3%	1.0%	4.7%	0.606640	1.106693	0.542136	0.019999	2.247197	
21	0.65	1363148	723706285	1498	1454	0.00%	0.00%	288314110	205862039	82452071	27804367	21635773	6168594	14294057	10117957	4176100	9.6%	10.5%	7.5%	5.0%	4.9%	5.1%	27805865	21637271	6168594	14295511	10119411	4176100	1.4%	1.1%	5.1%	0.766664	1.427812	0.732340	0.027991	2.443650	
21	0.75	1572864	795585389	1498	1454	0.00%	0.00%	320795182	228415977	92379205	31135283	24274160	6861123	16588223	11942710	4645513	9.7%	10.6%	7.4%	5.2%	5.2%	5.0%	31136781	24275658	6861123	16589677	11944164	4645513	1.5%	1.2%	5.0%	0.920716	1.662386	0.841063	0.031334	2.557427	
21	0.85	1782579	868428151	1494	1450	0.00%	0.00%	353764667	251330916	102433751	34473167	26919527	7553640	18936043	13793525	5142518	9.7%	10.7%	7.4%	5.4%	5.5%	5.0%	34474661	26921021	7553640	18937493	13794975	5142518	1.5%	1.2%	5.0%	1.061118	1.980394	1.143188	0.035560	2.979306	
21	0.9	1887436	907087407	1496	1452	0.00%	0.00%	371345721	263592788	107752933	36154736	28279097	7875639	20107816	14743867	5363949	9.7%	10.7%	7.3%	5.4%	5.6%	5.0%	36156232	28280593	7875639	20109268	14745319	5363949	1.6%	1.3%	5.0%	1.216421	2.064274	1.180260	0.041332	2.973788	
21	0.95	1992294	952497387	1495	1451	0.00%	0.00%	392227331	278277096	113950235	37877932	29750447	8127485	21328418	15787719	5540699	9.7%	10.7%	7.1%	5.4%	5.7%	4.9%	37879427	29751942	8127485	21329869	15789170	5540699	1.6%	1.3%	4.9%	1.371945	2.233826	1.245376	0.041334	2.998887	
21	0.98	2055209	987710319	1494	1450	0.00%	0.00%	408490881	289858898	118631983	38979561	30700966	8278595	22101997	16480821	5621176	9.5%	10.6%	7.0%	5.4%	5.7%	4.7%	38981055	30702460	8278595	22103447	16482271	5621176	1.6%	1.3%	4.7%	1.392801	2.267792	1.317166	0.047571	3.050990	
21	1	2097152	1089732246	1476	1432	0.00%	0.00%	466891496	339695717	127195779	40786319	32408446	8377873	23423079	17644524	5778555	8.7%	9.5%	6.6%	5.0%	5.2%	4.5%	40787795	32409922	8377873	23424511	17645956	5778555	1.5%	1.2%	4.5%	1.906790	1.893544	1.733719	0.042325	3.076930	
22	0.1	419430	722985647	1499	1452	0.00%	0.00%	251946369	187542135	64404234	19245007	17284642	1960365	6334436	4395420	1939016	7.6%	9.2%	3.0%	2.5%	2.3%	3.0%	19246506	17286141	1960365	6335888	4396872	1939016	0.6%	0.5%	3.0%	0.271246	0.477192	0.244769	0.008423	3.991036	
22	0.25	1048576	920221249	1497	1453	0.00%	0.00%	340340162	248568098	91772064	29165406	24364045	4801361	16411598	11642000	4769598	8.6%	9.8%	5.2%	4.8%	4.7%	5.2%	29166903	24365542	4801361	16413051	11643453	4769598	1.3%	1.0%	5.2%	0.705267	1.199799	0.599727	0.020795	4.552830	
22	0.5	2097152	1248949610	1494	1450	0.00%	0.00%	487665126	350280031	137385095	45698562	36162227	9536335	33497129	23989963	9507166	9.4%	10.3%	6.9%	6.9%	6.8%	6.9%	45700056	36163721	9536335	33498579	23991413	9507166	1.9%	1.5%	6.9%	1.288788	2.351250	1.220524	0.062896	5.216271	
22	0.65	2726297	1450825195	1495	1451	0.00%	0.00%	578340166	412978354	165361812	55628488	43555608	12072880	43670990	31634292	12036698	9.6%	10.5%	7.3%	7.6%	7.7%	7.3%	55629983	43557103	12072880	43672441	31635743	12036698	2.2%	1.7%	7.3%	1.698520	3.006610	1.580809	0.051016	5.637691	
22	0.75	3145728	1585873332	1494	1450	0.00%	0.00%	639020041	454946919	184073122	62251099	48517256	13733843	50467456	36772768	13694688	9.7%	10.7%	7.5%	7.9%	8.1%	7.4%	62252593	48518750	13733843	50468906	36774218	13694688	2.3%	1.8%	7.4%	1.966143	3.434805	1.838442	0.063041	6.069802	
22	0.85	3565158	1725933496	1493	1449	0.00%	0.00%	702151408	498712560	203438848	68899553	53603230	15296323	57252677	41992392	15260285	9.8%	10.7%	7.5%	8.2%	8.4%	7.5%	68901046	53604723	15296323	57254126	41993841	15260285	2.4%	1.9%	7.5%	2.286150	3.842003	2.142225	0.068263	6.191928	
22	0.9	3774873	1819377195	1495	1451	0.00%	0.00%	745173474	528996851	216176623	72350465	56732603	15617862	60791690	45206658	15585032	9.7%	10.7%	7.2%	8.2%	8.5%	7.2%	72351960	56734098	15617862	60793141	45208109	15585032	2.4%	1.9%	7.2%	2.562487	4.131887	2.242204	0.071326	6.397741	
22	0.95	3984588	1917694944	1496	1452	0.00%	0.00%	790618738	561063860	229554878	75834710	59895307	15939403	64302946	48413348	15889598	9.6%	10.7%	6.9%	8.1%	8.6%	6.9%	75836206	59896803	15939403	64304398	48414800	15889598	2.4%	2.0%	6.9%	2.681760	4.487556	2.492954	0.073306	6.583422	
22	0.98	4110418	2001618969	1497	1453	0.00%	0.00%	829733721	588980351	240753370	78112223	62052771	16059452	66609255	50596138	16013117	9.4%	10.5%	6.7%	8.0%	8.6%	6.7%	78113720	62054268	16059452	66610708	50597591	16013117	2.4%	2.0%	6.7%	2.818309	4.694672	2.705436	0.079629	6.671730	
22	1	4194304	2170539354	1476	1432	0.00%	0.00%	928133784	676011615	252122169	81509327	65174345	16334982	70052217	53753316	16298901	8.8%	9.6%	6.5%	7.5%	8.0%	6.5%	81510803	65175821	16334982	70053649	53754748	16298901	2.3%	1.9%	6.5%	3.704016	3.848615	3.572971	0.080529	6.677209	
23	0.1	838860	1445738125	1513	1504	0.00%	0.00%	503813812	375027021	128786791	38505818	34585920	3919898	17075880	13171747	3904133	7.6%	9.2%	3.0%	3.4%	3.5%	3.0%	38507331	34587433	3919898	17077384	13173251	3904133	0.9%	0.7%	3.0%	0.545200	0.939425	0.516011	0.017065	8.801671	
23	0.25	2097152	1840221119	1506	1497	0.00%	0.00%	680610435	497087988	183522447	58347647	48745768	9601879	40513261	30919480	9593781	8.6%	9.8%	5.2%	6.0%	6.2%	5.2%	58349153	48747274	9601879	40514758	30920977	9593781	1.6%	1.3%	5.2%	1.307265	2.300350	1.208750	0.039792	9.498335	
